exit_pos: 12 0
4
enter: ^ +
exit: _ +
wall: # -
free: . +
############_##########
#...#........###...####
#...#...########...####
##.###.##########.#####
##.....#####.####.#####
######............#####
############.##########
############^##########